##########
#.#.######
#. .#=####
###.#\####
# ....o%.#
#=#%#.####
#....oo=%#
#%#.##.###
#o... =. #
##########
